2000000000000000000
1000000000000000000
1000003000000000000
1000000000000000000
1000000000000000000
1000000222220000000
1000000000000000000
1200000000000000022
1122222222222222211
1111111111111111111
1111111111111111111
1111111111111111111
1111111111111111111
1111111111111111111