2222222222222222222
1101100000000000000
1100100000000000000
1000000000000000000
1000000000000000000
1000000222220000000
1000000000000000000
1200000000000000022
1122222222222222211
1111111111111111111
1111111111111111111
1111111111111111111
1111111111111111111
1111111111111111111