11111111111111111111
10000000000000000001
15555555555555555551
10000000000000000001
10002222222222222221
10000000000000000001
11111111111111111001
10000000000000000001
10011111111111111111
10000000000000000001
12222222222222222221